###############
#  *********  #
# #*#*#*#*#*# #
#*************#
#*#*#*#*#*#*#*#
#*************#
#*#*#*#*#*#*#*#
#*************#
#*#*#*#*#*#*#*#
#*************#
#*#*#*#*#*#*#*#
#*************#
# #*#*#*#*#*# #
#  *********  #
###############